111111111111111111111111
1E000000000000000000P001
1P000000000000C000000001
111111111111111111111111
