111111111111111111111111
1E0000000000000000000001

1P000000000000C000000001
111111111111111111111111
