111111111111111111111111
1E0000000000000000000001
1PCCCCCCCCCCCCCCCCCC0001
1111111111111111111111111





