111111111111111111111111
1E0000000000000000000001
1P000000000000C00000000C
111111111111111111111111
